111111111111111S111111111111111
1000000000000000000100000000001
1011111110111111101110111111101
1010000010001000100010100000001
1010111011101010111010101111111
1010100010001010001000101000001
1011101110111110101111101011101
1000101000100010100000001010101
1110101011101110111111111010101
1000101000001000000000001000101
1011101111101011111111101111101
1010000000101010000000100000101
1010111110101010111110111110101
1010100000101010100010000010101
1010101111101010101011111010101
1010100000100010101000001010001
1110111110111010111111101011111
1000000010101000000000101000001
1011111010101111111110101111101
1010001010100000100010001000101
1010111010111110101011111011101
1010000010000010101000000010001
1011111111111010111111111010111
1000000000001010000000001000001
1110111111101011111111101111101
1000100000101000000000101000101
1011101110111111111110101010101
1010001010000000000000100010001
1010111011111111111111111111101
1000000000000000000000000000001
111111111111111E111111111111111